11111111111111111111111111111111111111111111111111111111111111111111111111111111
11111111111111111111111111111111111111111111111111111111111111111111111111111111
11110000000000000000000000000000000000111000000000000000000000000000000000001111
11110000000000000000000000000000000000111000000000000000000000000000000000001111
11110000000000000000000002000000000000111000000000000000000000000000000000001111
11110000000000000000000000000000000000111000000000000000000000000000000000001111
11110000000000000000000000000000000000111000000000000000000000000000000000001111
11110000001111111100000111111111000000111000000111111111100000111111111000001111
11110000001111111100000111111111000000111000000111111111100000111111111000001111
11110000000000000000000000000000000000000000000000000000000000000000000000001111
11110000000000000000000000000000000000000000000000000000000000000000000000001111
11110000000000000000000000000000000000000000000000000000000000000000000000001111
11110000000000000000000000000000000000000000000000000000000000000000000000001111
11110000000000000000000000000000000000000000000000000000000000000000000000001111
11110000001111111100000111000001111111111111111100000011100000111111111000001111
11110000001111111100000111000001111111111111111100000011100000111111111000001111
11110000001111111100000111000000000000011000000000000011100000111111111000001111
11110000001111111100000111000000000000011000000000000011100000111111111000001111
11110000000000000000000111000000000000011000000000000011100000000000000000001111
11110000000000000000000111000000000000011000000000000011100000000000000000001111
11110000000000000000000111000000000000011000000000000011100000000000000000001111
11110000000000000000000111000000000000011000000000000011100000000000000000001111
11110000000000000000000111000000000000000000000000000011100000000000000000001111
11111111111111111000000111111111100000000000001111111111100000011111111111111111
11111111111111111000000111111111100000000000001111111111100000011111111111111111
00000000000000011000000111000000000000000000000000000011100000011000000000000000
00000000000000011000000111000000000000000000000000000011100000011000000000000000
00000000000000011000000111000000000000000000000000000011100000011000000000000000
00000000000000011000000111000000000000000000000000000011100000011000000000000000
11111111111111111000000111000000000000000000000000000011100000011111111111111111
11111111111111111000000111000000111111111111111100000011100000011111111111111111
00000000000000000000000000000000111111111111111100000000000000000000000000000000
00000000000000000000000000000000111000000000011100000000000000000000000000000000
00000000000000000000000000000000111000000000011100000000000000000000000000000000
00000000000000000000000000000000111000000000011100000000000000000000000000000000
00000000000000000000000000000000111111111111111100000000000000000000000000000000
11111111111111111000000111000000111111111111111100000011100000011111111111111111
11111111111111111000000111000000000000000000000000000011100000011111111111111111
00000000000000011000000111000000000000000000000000000011100000011000000000000000
00000000000000011000000111000000000000000000000000000011100000011000000000000000
00000000000000011000000111000000000000000000000000000011100000011000000000000000
00000000000000011000000111000000000000000000000000000011100000011000000000000000
11111111111111111000000111111111100000000000001111111111100000011111111111111111
11111111111111111000000111111111100000000000001111111111100000011111111111111111
11110000000000000000000111000000000000011000000000000011100000000000000000001111
11110000000000000000000111000000000000011000000000000011100000000000000000001111
11110000000000000000000111000000000000011000000000000011100000000000000000001111
11110000000000000000000111000000000000011000000000000011100000000000000000001111
11110000000000000000000111000000000000011000000000000011100000000000000000001111
11110000001111111100000111000001111111111111111100000011100000111111111000001111
11110000001111111100000111000001111111111111111100000011100000111111111000001111
11110000000000000000000000000000000000000000000000000000000000000000000000001111
11110000000000000000000000000000000000000000000000000000000000000000000000001111
11110000000000000000000000000000000000000000000000000000000000000000000000001111
11110000000000000000000000000000000000000000000000000000000000000000000000001111
11110000000000000000000000000000000000000000000000000000000000000000000000001111
11110000001111111100000111111111000000111000000111111111100000111111111000001111
11110000001111111100000111111111000000111000000111111111100000111111111000001111
11110000000000000000000000000000000000111000000000000000000000000000000000001111
11110000000000000000000000000000000000111000000000000000000000000000000000001111
11110000000000000000000002000000000000111000000000000000000000000000000000001111
11110000000000000000000000000000000000111000000000000000000000000000000000001111
11110000000000000000000000000000000000111000000000000000000000000000000000001111
11111111111111111111111111111111111111111111111111111111111111111111111111111111
11111111111111111111111111111111111111111111111111111111111111111111111111111111