111111111111111111111
100000000010000000001
101101111010111101101
101100000000000000001
101101101111101101101
101101100010001101101
100001111010111100001
111101111000111101111
000101100000001101000
111101101111101101111
000000001000100000000
111101101111101101111
000101100000001101000
111101111000111101111
100001111010111100001
101101100010001101101
101101101111101101101
100000000000000000001
101101111010111101101
100000000010000000001
111111111111111111111