00000000000000000000000000000000000000000000000000000000000000000000000000000000
00000000000000000000000000000000000000000000000000000000000000000000000000000000
11111111111111111111111111111111111111111111111111111111111111111111111111111111
11111111111111111111111111111111111111111111111111111111111111111111111111111111
11111111111111111111111111111111111111111111111111111111111111111111111111111111
11110000000000000000000000000000000000111000000000000000000000000000000000001111
11110000000000000000020002000000000000111000000000000000000000000000000000001111
11110000000000000000000000000000000000111000000000000000000000000000000000001111
11110000111111111110000111111111110000111000111111111111100001111111111100001111
11110000111111111110000111111111110000111000111111111111100001111111111100001111
11110000111111111110000111111111110000111000111111111111100001111111111100001111
11110000000000000000000000000000000000000000000000000000000000000000000000001111
11110000000000000000000000000000000000000000000000000000000000000000000000001111
11110000000000000000000000000000000000000000000000000000000000000000000000001111
11110000111111111110000111100001111111111111111110000111100001111111111100001111
11110000111111111110000111100001111111111111111110000111100001111111111100001111
11110000111111111110000111100001111111111111111110000111100001111111111100001111
11110000000000000000000111100000000000111000000000000111100000000000000000001111
11110000000000000000000111100000000000111000000000000111100000000000000000001111
11110000000000000000000111100000000000111000000000000111100000000000000000001111
11111111111111111110000111111111100000000000001111111111100001111111111111111111
11111111111111111110000111111111100000000000001111111111100001111111111111111111
11111111111111111110000111111111100000000000001111111111100001111111111111111111
00000000000000011110000111100000000000000000000000000111100001111000000000000000
00000000000000011110000111100000000000000000000000000111100001111000000000000000
00000000000000011110000111100000000000000000000000000111100001111000000000000000
11111111111111111110000111100001111111111111111110000111100001111111111111111111
11111111111111111110000111100001111111111111111110000111100001111111111111111111
11111111111111111110000111100001111111111111111110000111100001111111111111111111
00000000000000000000000000000001111000000000011110000000000000000000000000000000
00000000000000000000000000000001111000000000011110000000000000000000000000000000
00000000000000000000000000000001111000000000011110000000000000000000000000000000
11111111111111111110000111100001111111111111111110000111100001111111111111111111
11111111111111111110000111100001111111111111111110000111100001111111111111111111
11111111111111111110000111100001111111111111111110000111100001111111111111111111
00000000000000011110000111100000000000000000000000000111100001111000000000000000
00000000000000011110000111100000000000000000000000000111100001111000000000000000
00000000000000011110000111100000000000000000000000000111100001111000000000000000
11111111111111111110000111111111100000000000001111111111100001111111111111111111
11111111111111111110000111111111100000000000001111111111100001111111111111111111
11111111111111111110000111111111100000000000001111111111100001111111111111111111
11110000000000000000000111100000000000111000000000000111100000000000000000001111
11110000000000000000000111100000000000111000000000000111100000000000000000001111
11110000000000000000000111100000000000111000000000000111100000000000000000001111
11110000111111111110000111100001111111111111111110000111100001111111111100001111
11110000111111111110000111100001111111111111111110000111100001111111111100001111
11110000111111111110000111100001111111111111111110000111100001111111111100001111
11110000000000000000000000000000000000000000000000000000000000000000000000001111
11110000000000000000000000000000000000000000000000000000000000000000000000001111
11110000000000000000000000000000000000000000000000000000000000000000000000001111
11110000111111111110000111111111110000111000111111111111100001111111111100001111
11110000111111111110000111111111110000111000111111111111100001111111111100001111
11110000111111111110000111111111110000111000111111111111100001111111111100001111
11110000000000000000000000000000000000111000000000000000000000000000000000001111
11110000000000000000000000000000000000111000000000000000000000000000000000001111
11110000000000000000000000000000000000111000000000000000000000000000000000001111
11111111111111111111111111111111111111111111111111111111111111111111111111111111
11111111111111111111111111111111111111111111111111111111111111111111111111111111
11111111111111111111111111111111111111111111111111111111111111111111111111111111
00000000000000000000000000000000000000000000000000000000000000000000000000000000





