111111111111111111111
132222222212222222231
121121111212111121121
121122222222222222221
121121121111121121121
121121122212221121121
122221111212111122221
111121111222111121111
000121122222221121000
111121121111121121111
222222221000122222222
111121121111121121111
000121122222221121000
111121111222111121111
122221111212111122221
121121122212221121121
121121121111121121121
122222222222222222221
121121111212111121121
132222222212222222231
111111111111111111111