111111111111111111111
100002000010000000001
100100110010011001001
100000000000000000001
100100101111101001001
100100100010001001001
100000100010001000001
111100110000011001111
000100100000001001000
111100101111101001111
000000001000100000000
111100101111101001111
000100100000001001000
111100110000011001111
100000100010001000001
100100100010001001001
100100101111101001001
100000000000000000001
100100110010011001001
100000000010000000001
111111111111111111111