00000000000000000000000000000000000000000000000000000000000000000000000000000000
00000000000000000000000000000000000000000000000000000000000000000000000000000000
11111111111111111111111111111111111111111111111111111111111111111111111111111111
11111111111111111111111111111111111111111111111111111111111111111111111111111111
11111111111111111111111111111111111111111111111111111111111111111111111111111111
11110000000000000000000000000000000000000000000000000000000000000000000000001111
11110000000000000000000000000000000000000000000000000000000000000000000000001111
11110000000000000000000000000000000000000000000000000000000000000000000000001111
11110000000000000000000000000000000000000000000000000000000000000000000000001111
11110000000000000000000000000000000000000000000000000000000000000000000000001111
11110000000000000000000000000000000000000000000000000000000000000000000000001111
11110000000000000002000000000000000000000000000000000000000000000000000000001111
11110000000000000000000000000000000002000000000000000000000000000000000000001111
11110000000000000000000000000000000000000000000000000000000000000000000000001111
11110000000000000000000000000000000000000000000000000000000000000000000000001111
11110000000000000000000000000000000000000000000000000000000000000000000000001111
11110000000000000000000000000000000000000000000000000000000000000000000000001111
11110000000000000000000000000000000000000000000000000000000000000000000000001111
11110000000000000000000000000000000000020000000000000000000000000000000000001111
11110000000000000000000000000000000000000000000000000000000000000000000000001111
11110000000000000000000000000000000000000000000000000000000000000000000000001111
11110000000001110000000000000000000000000000000000000000000000000000000000001111
11110000000001110000000000000000000000000000000000000000000000000000000000001111
11110000000001110000000000000000000000000000000000000000000000000000000000001111
11110000000001110000000000000000000000000000000000000000000000000000000000001111
11110000000001110000000000000000000000000000000000000000000000000000000000001111
11110000000000000000000000000000000000000000000000000000000000000000000000001111
11110000000000000000000000000000000000000000000000000000000000000000000000001111
11110000000000000000000000000000000000000000000000000000000000000000000000001111
11110000000000000000000000000000000000000000000000000000000000000000000000001111
11110000000000000000000000000000000000000000000000000000000000000000000000001111
11110000000000000000000000000000000000000000000000000000000000000000000000001111
11110000000000000000000000000000000000000000000000000000000000000000000000001111
11110000000000000000000000000000000000000000000000000000000000000000000000001111
11110000000000000000000000000000000000000000000000000000000000000000000000001111
11110000000000000000000000000000000000000000000000000000000000000000000000001111
11110000000000000000000000000000000000000000000000000000000000000000000000001111
11110000000000000000000000000000000000000000000000000000000000000000000000001111
11110000000000000000000000000000000000000000000000000000000000000000000000001111
11110000000000000000000000000000000000000000000000000000000000000000000000001111
11110000000000000000000000000000000000000000000000000000000000000000000000001111
11110000000000000000000000000000000000000000000000000000000000000000000000001111
11110000000000000000000000000000000000000000000000000000000000000000000000001111
11110000000000000000000000000000000000000000000000000000000000000000000000001111
11110000000000000000000000000000000000000000000000000000000000000000000000001111
11110000000000000000000000000000000000000000000000000000000000000000000000001111
11110000000000000000000000000000000000000000000000000000000000000000000000001111
11110000000000000000000000000000000000000000000000000000000000000000000000001111
11110000000000000000000000000000000000000000000000000000000000000000000000001111
11110000000000000000000000000000000000000000000000000000000000000000000000001111
11110000000000000000000000000000000000000000000000000000000000000000000000001111
11110000000000000000000000000000000000000000000000000000000000000000000000001111
11110000000000000000000000000000000000000000000000000000000000000000000000001111
11110000000000000000000000000000000000000000000000000000000000000000000000001111'
11110000000000000000000000000000000000000000000000000000000000000000000000001111
11111111111111111111111111111111111111111111111111111111111111111111111111111111
11111111111111111111111111111111111111111111111111111111111111111111111111111111
11111111111111111111111111111111111111111111111111111111111111111111111111111111
00000000000000000000000000000000000000000000000000000000000000000000000000000000
00000000000000000000000000000000000000000000000000000000000000000000000000000000




