111111111111111111111
100000000010000000001
101110111010111011101
100000000000000000001
101110101111101011101
100000100010001000001